白色粉	白色土
品红粉	品红土
粉红粉	粉红土 
红色粉	红色土
橙色粉	橙色土
黄色粉	黄色土
黄绿粉	黄绿土
绿色粉	绿色土
青色粉	青色土
淡蓝粉	淡蓝土
蓝色粉	蓝色土
紫色粉	紫色土
棕色粉	棕色土
淡灰粉	淡灰土
灰色粉	灰色土
黑色粉	黑色土
白色瓦	白色瓦
品红瓦	品红瓦
粉红瓦	粉红瓦
红色瓦	红色瓦
橙色瓦	橙色瓦
黄色瓦	黄色瓦
黄绿瓦	黄绿瓦
绿色瓦	绿色瓦
青色瓦	青色瓦
淡蓝瓦	淡蓝瓦
蓝色瓦	蓝色瓦
紫色瓦	紫色瓦
棕色瓦	棕色瓦
淡灰瓦	淡灰瓦
灰色瓦	灰色瓦
黑色瓦	黑色瓦
铁石块	铁石块
金石块	金石块
红石块	炸弹块
青金块	青金块
钻石块	海晶块
绿宝块	绿宝块
石英块	石英块
草方块	草方块
石头块	石头块
砂岩块	砂岩块
地狱岩	地狱岩
黏土块	黏土块
浮冰块	浮冰块
丛林板	花岗岩
云杉板	灰土块
橡木板	橡木板
树叶块	树叶块
蜘蛛网	蜘蛛网